13
8
1111111111111
1000007000001
1023330000001
1055540000001
1000000000001
1006660000001
1000007000001
1111111111111