15
8
111111111111111
100000700000001
102333000000001
100000000000001
100000000000001
100666000004501
100000700000001
111111111111111