8
8
11111111
10000071
10233301
10555401
10000001
10066601
10000071
11111111