8
8
11111111
10000001
10233301
10555401
10000001
10066601
10000001
11111111